0 0 0 0 0 0 0 0 0 0 0 0 0 0 0 0 0 0 0 0 0
0 M M M M M M M M M M M M M M M M M R M 0
0 M L L L L L L L L M M R R R R R R G G 0
0 M L L L L M M M M M M M M G G G G W W 0
0 M L L M M M M M M G R G G G G G G W W 0
0 M L M G F F F G G R G G G G G G W W W 0
0 M L M G F F G G R G G G G G G G G G W 0
0 M M G F F F F G R G G G G G G G W W W 0
0 M F F F F F F F R G G G G G G G G G W 0
0 G G F F F F G G R G G G G G G G W W W 0
0 G F F F F G G R G G G G G G G G G W W 0
0 F F F F F G R G G G G G G G G G W W W 0
0 F F C F F R G G G G G G G G G G G W W 0
0 F F F F R G G G G G G G G G G G W W W 0
0 R R R R G G G G G G G G G G G G W W W 0
0 F F F F R F F F G H G G G G G W W W W 0
0 F F F F F R F F G G G G G G G G G G W 0
0 F F F F F F R F G G G G G G G G G W D 0
0 F F F F F F R F G G G G G G G G G D W 0
0 F F F F F R F F G G G G G G G G G D D 0
0 0 0 0 0 0 0 0 0 0 0 0 0 0 0 0 0 0 0 0 0
